xxxxxxxxxx
xo       x
x xxx xx x
x        x
xxxxxx   x
x        x
x   xxxxxx
x        x
x  x   x x
xxxxxxxxxx